1111111111111111111111111111111111111111111111111111111111111111111111111111111111111111111111111111
1000000005000500050005000000000000000000500000000000000000000000000000000000000000000000000000000001
1000000000000000000000000000000000000000000000000000000000000000000000000000000000000000000000000001
1000000000000000000000000000000000000000400000000000000000000000000000000001245376000000000000000001
1000000012000200020002900002000000000000100000000000000000000000000000000000000000000000000000000001
1300000010000000000000000000000000000000100000000000000000000000000000000000000000000000000000000001
1000000010000000000000000000000000000000100000000000000000000000000000000000000000000000000000000001
1000000310000002000000000100000000002000100000000000000000000000000000000000000000000000000000000001
1000000010000000000000000000000000000003100000000000000000000000000000000000000000000000000000000001
1300000010000000000000000000030000000000100000000000000000000000000000000000000000000000000000000001
1000000010000000002000000000000000000000100000044444444444444444444444400000000000000000000000000001
1000000310020000000000000000000000300000100000050505050505050505050505000000000000000000000000000001
1000000010000000000000000200000000000000100000400040004000400040004000400000000000000000000000000001
130000AA10000000000009000000000000000000100AA0100010001000100010001000100000000000000000800000000001
1111111110000003000000000000003000000000119111113111311131113111311131111111111111111111111111111111