1111111111111111111111111111111111111111111111111111111111111111111111111111111111111111111111111111
1000000000000000000000000000000000000000000000000000000000000000000000000000000000000000000000000001
1000000000000000000000000000000000000000000000000000000000000000000000000000000000000000000000000001
1000000000000000000000000000000000000000000000000000000000000000000000000000000000000000000000000001
1000000000000000000000000000000000000000000000000000000000000000000000000000000000000000000000000001
1000000000000000000000000000000000000000000000000000000000000000000000000000000000000000000000000001
1000000000000000000000000000000000000000000000000000000000000000000000000000000000000000000000000001
1111111111111111111111111111111111111111111151115111511510000000000000000000000000000000000000000001
1000000000000000000000000000000000000000005000500050005000000000000000000000000000000000000000000001
1000000000000000000000000000000000000000000000000000000000000000000000000000000000000000000000000001
1000000000000000000001414141000000000000100030003000300040400000000000000000000000000000000000000001
1000000000000122222221111111000000000000100000000000000010100008000000000000000000000000000000000001
1110000000001110000000000000000000000000102000200020000010000011100000000000000000000000000000000001
1000000000011111000000000000080000000000144444444444443410100111110000000000000000000000000000000001
1111111111111111111111111111119130000003111111111111111114191111111111111111111111111111111111111111