1111111111111111111111111111111111111111111111111111111111111111111111111111111111111111111111111111
1551510010000000000000000000000000000000000000000000000000000000000000000000000000000000000000000001
1000000010000000000000000000000000000000000000000000000000000000000000000000000000000000000000000001
1000000010000000000000000000000000000000000000000000000000000000000000000000000000000000000000000001
1000196010000000000000000000000000000000000000000000000000000000000000000000000000000000000000000001
1000010010000000000000000000000000000000000000000000000000000000000000000000000000000000000000000001
1000010710000000000000000000000000000000000000000000000000000000000000000000000000000000000000000001
1000310010000000000000000000000000000000000000000000000000000000000000000000000000000000000000000001
1000016010000000000000000000000000000000000000000000000000000000000000000000000000000000000000000001
1000010000000000000000000000000000000000000000000000000000000000000000000000000000000000000000000001
1000312211111111111111111111111000000000000000000000000000000000000000000000000000000000000000000001
1000010010050005000500200000000000000000000000000000000000000000000000000000000000000000000000000001
1000010000000000000002000000000000000000000000000000000000000000000000000000000000000000000000000001
1000011912202420242020420000000000000000000000000000000000000000000000000000000000000000000000004641
1000310000010001000100000000000000000000000000000000000000000000000000000000000000000000000000001111